One	Uno	Ichi	Eins
Two	Dos	Ni	Zwei
Three	Tres	San	Drei
Four	Quatro	Yon	Vier
Five	Cinco	Go	Funf
Six	Seis	Roku	Sechs
Seven	Siete	Nana	Sieben
Eight	Ocho	Hachi	Acht
Nine	Nueve	Kyuu	Neun
Ten	Diez	Juu	Zehn
Black	Negro	Kuro	Schwarz
White	Blanco	Shiro	Weib
Gray	Gris	Haiiro	Grau
Red	Rojo	Aka	Rot
Blue	Azul	Ao	Blau
Yellow	Amarillo	Kiiro	Gelb
Purple	Morado	Murasaki	Lila
Orange	Anaranjado	Orenji	Orange
Green	Verde	Midori	Grun
Pink	Rosado	Pinku	Rosa
Brown	Marron	Chairo	Braun